 *********
       ***
****** ***
****** ***
****** ***
**     ***
**** *****
****      
**** *****
**********