* ********
*   *    *
* *** ** *
*     ** *
* * * ** *
* * ***  *
* *** *  *
*   * *  *
*   *    *
******** *