**********
         *
** *******
*       **
* ***** **
***     **
*** ******
*       **
**** ** **
**** *****