*      ***
*        *
*       **
*       **
******* **
******* **
** **** **
** **** **
**         
**********