* ********
*   *    *
* *** ** *
* *   ** *
* * * ****
*   * *  *
* *** *  *
*   * *  *
*   *    *
******** *