****   ***
****   ***
*        *
* *** ****
* *** ****
*         
* *** ****
* *** ****
*     ****
**********