**********
         *
** *******
** *******
*       **
******* **
*** *** **
*       **
**** *****
**** *****