**********
         *
** *** * *
** *******
*       **
******* **
*** *** **
*         
**********
**********